Kani
##########
#x.......#
#C..C....#
#...x..P.#
##########
