Le Magnifiak Board de Ju
##########
#x.x#....#
..C...CP.#
#........#
##########