Un Board assez simple...
##########
#x.x#....#
#.C...CP.#
#........#
##########