Le Magnifiak Board de Ju
##########
#x.x#....#
#C..C..P.#
#........#
##########