Le Board du futur
##########
#x.x....P#
#C..C....#
#........#
####.#####
####.#####
#x.x.....#
#C..C....#
#........#
####.#####
####.#####
#x.x.....#
#C..C....#
#........#
##########