Moibibi
##########
#x.....P.#
#C..C....#
#........#
####x#####
