Noukiiii
##########
#x.....P.#
#C..C....#
#.......x#
##########