A Simple Board
##########
#x.x#....#
#...C..P.#
#....C...#
##########